############........
#.........##........
#.........##........
#.........##........
#.........##........
#......#####..##....
#..#..........##....
####..........######
############..######
....................
....................
........####....#...
...#....####....#...
...##...####....#...
........####....#...
........####........
........####........