#####################################
############....#####################
############....#####################
###########.....#######..#..#..######
#############.#######............####
##########........###............####
####.##.##.#....#.###............####
####....##........###...#..#..#..####
####....##........###..............##
#................................#..#
#................................#..#
####....##........###..............##
####....##........###...#..#..#..####
####.##.##.#....#.###............####
##########........###............####
#############.#######............####
###########.....#######..#..#..######
###########.....#####################
###########...#######################
#####################################