###########....#####################
###########....#####################
##########.....#######..#..#..######
############.#######............####
#########........###............####
###.##.##.#....#.###............####
###....##........###...#..#..#..####
###....##........###..............##
................................#..#
................................#..#
###....##........###..............##
###....##........###...#..#..#..####
###.##.##.#....#.###............####
#########........###............####
############.#######............####
##########.....#######..#..#..######
##########.....#####################
##########...#######################